111111
1lE011
1CCP11
111111
1CCP11
111111
