1111111111111111111111
10P0000000001000000001
100000000000E000000001
1000000C00001000000001
10C0000000000000000001
1111111111111111111111