11111111111111111111111
10P00000000010000000011
100000000000E1000000011
10000000000010000000011
10C00000000000000000011
11111111111111111111111
