1111111111111111111111111
10P0000000001000000001111
100000000000E100000001111
1000000000001000000001110
10C0000000000000000001111
1111111111111001111111111
1111111101111111111111111
