1111111111111111111111
10P0000000001000000001
100000010000E000000001
1000001C00001000000001
10C0000100000000000001
1111111111111111111111